NO ./texture/north.xpm
SO ./texture/south.xpm
WE ./texture/west.xpm
EA ./texture/east.xpm

F 133,109,35
C 209,118,95

111111111111111111111111111111111
100000000000000000000000000000E01
111111111111111111111111111111111